
 

NO ./textures_xpm/naturalbricks_hd_verydark.xpm
SO ./textures_xpm/naturalbricks_hd_middle.xpm
EA ./textures_xpm/naturalbricks_hd_middle.xpm
WE ./textures_xpm/naturalbricks_hd_middle.xpm

F 10,12,0
C 111,30,0
   
    
     
      

       
        
   
      11111111111111111111111
      1000000001N1000000001
      101100001110000000001
      111001010101010000001
      111111111111111111111
        111111111111111111111
      111111111111111111111
1111111111111111111  
111111111111111111111111111
 
 
 
111111111111111111111111111
100000000001100000000000001
11000001111100010101111011011
11110111 11011101 101111111
11111111 11111111 111111111